11111111111
1110C000001
1C001010C01
10010C10101
1P00C00E0C1
11111111111