1111111111111111111
1C01101C00001C000E1
1000C01111C01000111
1000100000001C00001
1C0100C000000010001
1P0001100C0000100C1
1111111111111111111