11111111111
1110C00000001
1C001010C001
10010C1011
1P00C00E0C1
11111111111