11111111111111111111
11100000000000000E1C
1111111111111111111P