11111111111111111111
111A000P000000000E1C
11111111111111111111