11111111111
1110C000011
1C001011C01
10010C11101
1P00C11E1C1
11111111111